NO textures/wall/wall_01.xpm
SO textures/wall/wall_05.xpm
WE textures/wall/wall_03.xpm
EA textures/wall/wall_04.xpm

C 69,69,69
F 36,45,40


111111111111111111111
10000000000N000000001
100000001000000000001
100000000100000000001
100000000000000000001
100000000000010000001
121000001210000000001
101010101211112110001
100000000000010000001
100000000000010000001
100000000000000000001
100012101210000010001
100000000000000000001
111110101211101211101
100000000000000000001
100000101000101000001
100000000000000000001
101111101011101111101
100000000000000000001
101000001010100000101
101011111010111110101
101010001010100010101
101110101010101010101
100000101010001010001
111111101011111011101
100000101000100010001
101110101210101110101
101000100000100010101
101011111211111010101
100010000000000010001
101010111011111111101
101000001000000000001
111111111111111111111
111000001000000000001
11111111111111111111
